25 20
 #######r#############r##
#..p..#...s...#bbB......#
#.....#.......#.....#####
#.#####.......#.....r
#...B.........#.g...#####
r...b..................p#
#...........#############
#######.....#
      #.....##########r##
#######......BBBB.......#
#..pb.............s.....#
#...B..................p#
#.s......#########r######
#......bb#
r........################
#BBbbBB.........B...s...#
######..g.......b......pr
     #..................#
     #.........@........#
     #####r##############

