25 20
 #######r#############r##
#..p..#...s...#bbB.....k#
#.....#.......#.....#####
#.#####.......#.....r
#...B.........#.g...#####
r...b..................p#
#...........#############
#######.....#
      #.....##########r##
#######......BBBB.......#
#k.pb.............s.....#
#...B..................p#
#.s......#########r######
#......bb#
r........################
#BBbbBB.........B...s...#
######..g.......b......pr
     #..................#
     #y........@........#
     #####r##############

