25 20
 #######r#############r##
#..p..#...s..p#bbB....p.#
#...uu#.......#.p...#####
#d#####.......#.....r
#...B...p.....#.g...#####
r...b........p......dl.y#
#...........#############
#######u...b#
      #b....##########r##
#######p.....BbBB.p....k#
#..pb.............s.u...#
#...B...............u..p#
#.s.....B#########r######
#......bb#
r.p......################
#BBbbBB.........Bp..s..k#
######..g.......buu....pr
     #u.................#
     #uu.......@...p....#
     #####r##############
