16 12
 ###############
#..............#
#.oo...oo...oo.#
#.o.o.o..o.o.o.#
#.o..o....o..o.#
#.o..........o.#
#.o....@.....o.#
#.o..........o.#
#.oooooooooooo.#
#..............#
#..............#
################

